MMMMMMMMMMMMMMMMMMMMMMMMMMMMMMMM
MTVVTTTTTTTTTTTRRTTTTTTTTTTTTTDM
MDTTTTTTTTTTTTTTTTTTTTTTTTTTTTRM
MRTMMMMMMMMMMMMRRMMMMMMMMMMMMTTM
MTTMDTTTTTTTTTDTTDTTTTTTTTTDMTTM
MTTMTTTTTTTTTDTTTTDTTTTTTTTTMTTM
MTTMTTTTTTTTDTTTTTTDTTTTTTTTMTTM
MTTMTTTTTTTDTTTTTTTTDTTTTTTTMTTM
MTTMTTTTTTDTTTTTTTTTTDTTTTTTMTTM
MTTMTTTTTDTTTTTTTTTTTTDTTTTTMTTM
MTTMTTTTDTTTTTTTTTTTTTTDTTTTMTTM
MTTMTTTDTTTTTTTTTTTTTTTTDTTTMTTM
MTTMTTDTTTTTTTTTTTTTTTTTTDTTMTTM
MTTMTDTTTTTTTTTTTTTTTTTTTTDTMTTM
MDTMDTTTTTTTTTTTPTTTTTTTTTTDMTDM
MMMMMMMMMMMMMMMMMMMMMMMMMMMMMMMM