MMMMMMMMMMMMMMMMMMMMMMMMMMMMMMMM
MTTTTTTTTTTTTTRPRTTTTTTTTTTTTTDM
MTTTTTTTTTTTTTTTTTTTTTTTDTTTTTTM
MTTTRRRRRMRRRRRRRRRRRRRRRRRRRRRM
MTTTRDTTTTDDTTTTTTTTTTTTTTTTTTTM
MTTTRTTDDTTTTTTTTTTTTTTTTTTTTTTM
MTTTRMMMMMMMMMMMMMMMMMMMTTTTTTTM
MTTTRTDDTTTTTTTTTTTTTTTTTTTTTTTM
MTTTRTTTTTTTTTTTTTTTTTTTTRRRRTTM
MTTTRTTTTTTTTTTTTTTTTVTTTTTTTTTM
MTTTRTTTTTTDDDTTTTTTTTTVTTTDTTTM
MTTTRTTTTTTTTTTTTTTTTTTTTTTTTTTM
MTTTRTTTTTTVVVTTTVVTTTRRRTTTTTTM
MTTTTTTTTTTVVVTTTTTTTTTTTTTTTTTM
MTTTTTTTTTTTTTTTTTTTTTTTTTTTTTDM
MMMMMMMMMMMMMMMMMMMMMMMMMMMMMMMM