MMMMMMMMMMMMMMMMMMMMMMMMMMMMMMMM
MPRVTTTTTTTTTTTTTTTTTTTTTRVTTTTM
MTTTTTTTTTTTVTTTTTRRRTTTTTTTTTTM
MTTTTTTTTTTTTTTTTTTTTTTTTTTTTTTM
MTTDTTTTTTTTTTTTTTVTTTTTTTTTTTTM
MMMMMMMMMMMMMMMMMMMMMMMMMMTTRTTM
MTTRTTVTTTTTTTTTTTTTTTTTTTTTTTTM
MTTTTTTTTTTTTTTTRRRRTTTTTTTVVTTM
MTTTTTTTTTTTTTTTTDDTTTTTTTTTTTTM
MTTVTTTTMMMMMMMMMMMMMMMMMMMMMMMM
MTTTTTTTTTTTTTRRTTTTTTTTTTTTTTTM
MTTTTTTVTTTTTTTTTTTTTVVTTTTTTTTM
MTTTTTTTTTTTVTTTTTTTTTTTRRRTTTTM
MTTTTTTTTTTTTTVVTTTTTTTTTTTTTTTM
MDTTTTTTTTTTTTTTTTTTTTTTTTTTTTDM
MMMMMMMMMMMMMMMMMMMMMMMMMMMMMMMM