MMMMMMMMMMMMMMMMMMMMMMMMMMMMMMMM
MPRVTTTTTTTTTTTTTTTTTTTTTTTTTTTM
MTTTTTTTTTTTTTTTTTTTTTTTTTTTRTTM
MTTTTTTTTTTTTTTTTTTTTTTTTTTRTRTM
MTTTTTTTTTTTTTTTTTTTTTTTTTTTTRTM
MTTTTTTTTTTTTTTTTTTTTTTTTTTTRTTM
MTTTTTTTTTTTTTTTTTTTTTTTTTTRRRTM
MTTTTTTTTTTTTTTTTTTTTTTTTTTTTTTM
MTTTTTTTTTTTTTTTTTTTTTTTTTTTTTTM
MTTTTTTTTTTTTTTTTTTTTTTTTTTTTTTM
MTTTTTTTTTTTTTTTTTTTTTTTTTTTTTTM
MTTTTTTTTTTTTTTTTTTTTTTTTTTTTTTM
MTTTTTTTTTTTTTTTTTTTTTTTTTTTTTTM
MTTTTTTTTTTTTTTTTTTTTTTTTTTTTTTM
MTTTTTTTTTTTTTTTTTTTTTTTTTTTTTDM
MMMMMMMMMMMMMMMMMMMMMMMMMMMMMMMM
