MMMMMMMMMMMMMMMMMMMMMMMMMMMMMMMM
MPTTTTTTTTTTRTTTTTTTTTTTTTTTTTTM
MTTTTTTTRTTTVTTTTTTTTTRTTTTVTTTM
MTTTTVTTTTTTTTTTTTTTTTTTTTTTTTTM
MTTTTTTTRTTTTTTTTTTVTTTRTTTTTTTM
MTTTTTTTTTTTTTTTTTTTTTTTTTTTVTTM
MTTTTTTTVTTTTTTTTTTTTTDTTTTTTTTM
MTTTTTTTRTTTTTTTVTTTRTTTTTTTTTTM
MTTTTTTTTTTTTTRTTTTTTTTTTTTTTTTM
MTTTTTTTTVTTTTTTTTTTVTTTTTTTTTTM
MTTTTRTTTTTTTDTTTRTTTTTTTTTTTTTM
MTTVTTTTTTTTTTTTTTTTTTTTTTVTTTTM
MTTTTTTTTTRTTTTTTVTTTTTTTTTTTTTM
MTTTTTTVTTTTTTTTTTTTTRTTTTTTTTTM
MTTTTTTTRTTTTTTVTTTTTDTTTTTVTTTM
MMMMMMMMMMMMMMMMMMMMMMMMMMMMMMMM